{
    "rooms": [
        {
            "size": 8,
            "layouts": [
                [
                    "########",
                    "#      #",
                    "# #### #",
                    "# #  # #",
                    "# # ## #",
                    "#    # #",
                    "###### #",
                    "########"
                ],
                [
                    "########",
                    "# #    #",
                    "# # ## #",
                    "#    # #",
                    "###### #",
                    "#      #",
                    "# ######",
                    "########"
                ],
                [
                    "########",
                    "#  #   #",
                    "# ## # #",
                    "#    # #",
                    "#### # #",
                    "#    # #",
                    "# #### #",
                    "########"
                ]
            ]
        },
        {
            "size": 9,
            "layouts": [
                [
                    "#########",
                    "#       #",
                    "# ##### #",
                    "# #   # #",
                    "# # # # #",
                    "# # # # #",
                    "#   #   #",
                    "####### #",
                    "#########"
                ],
                [
                    "#########",
                    "# #     #",
                    "# # ### #",
                    "#   #   #",
                    "##### # #",
                    "#     # #",
                    "# ##### #",
                    "#       #",
                    "#########"
                ],
                [
                    "#########",
                    "# #     #",
                    "# # ### #",
                    "#   #   #",
                    "##### # #",
                    "#   #   #",
                    "# ### ###",
                    "#       #",
                    "#########"
                ]
            ]
        },
        {
            "size": 10,
            "layouts": [
                [
                    "##########",
                    "#        #",
                    "# ###### #",
                    "# #    # #",
                    "# # ## # #",
                    "# # ## # #",
                    "#      # #",
                    "# ###### #",
                    "#        #",
                    "##########"
                ],
                [
                    "##########",
                    "# #      #",
                    "# # #### #",
                    "#   #  # #",
                    "### ## # #",
                    "#   ## # #",
                    "#      # #",
                    "# ###### #",
                    "#        #",
                    "##########"
                ],
                [
                    "##########",
                    "# #      #",
                    "# # #### #",
                    "#   #    #",
                    "##### ## #",
                    "#     ## #",
                    "# ###### #",
                    "#        #",
                    "#        #",
                    "##########"
                ]
            ]
        },
        {
            "size": 11,
            "layouts": [
                [
                    "###########",
                    "#         #",
                    "# ####### #",
                    "# #     # #",
                    "# # ### # #",
                    "#   # #   #",
                    "##### # ###",
                    "#   # #   #",
                    "# ### ### #",
                    "#         #",
                    "###########"
                ],
                [
                    "###########",
                    "# #       #",
                    "# # ##### #",
                    "#   #   # #",
                    "##### # # #",
                    "#   #     #",
                    "# # ##### #",
                    "# #       #",
                    "# #########",
                    "#         #",
                    "###########"
                ],
                [
                    "###########",
                    "#   #     #",
                    "### # ### #",
                    "#   #   # #",
                    "# ####### #",
                    "#   ##    #",
                    "#      ## #",
                    "#      #  #",
                    "# ##      #",
                    "#   ##    #",
                    "###########"
                ]
            ]
        },
        {
            "size": 12,
            "layouts": [
                [
                    "############",
                    "#          #",
                    "# ###  ### #",
                    "# #      # #",
                    "# # #  # # #",
                    "# # #  # # #",
                    "#          #",
                    "# # #### # #",
                    "# #      # #",
                    "# ###  ### #",
                    "#          #",
                    "############"
                ],
                [
                    "############",
                    "#          #",
                    "# ###  ### #",
                    "# # #  # # #",
                    "# # #  # # #",
                    "# # #  # # #",
                    "#          #",
                    "# # #### # #",
                    "# #      # #",
                    "# ###  ### #",
                    "#          #",
                    "############"
                ],
                [
                    "############",
                    "#          #",
                    "# ##   ##  #",
                    "# ##   ##  #",
                    "#          #",
                    "# ##   ##  #",
                    "# ##   ##  #",
                    "#          #",
                    "# ##   ##  #",
                    "# ##   ##  #",
                    "#          #",
                    "############"
                ]
            ]
        }
    ]
}